 1111111111
 1E00001001
 1P0C010001
 10f0100001
 1111111111