1111111111
1P00010001
1E00100001
10C0100001
1111101111