1111111111
1P00000001
100C000001
10000000E1
1111111111